111111111111111111111
1C100C000011111111111
1010000P0C11111011111
101000000011111111111
100000000001111111111
100E00000000000000001
100001C10000000000001
111111111111111111111
