111111111111111111111
1E10C0000P11111111111
1010000000000C1111111
100000000011111111111
100000000011111111111
111111111111111111111
